三極體	三極管
串列	串行
乙太網	以太網
二極體	二極管
互動式	交互式
人工智慧	人工智能
介面	接口
伺服器	服務器
位元組	字節
優先順序	優先級
儲存	保存
光碟	光盤
光碟機	光驅
全形	全角
列印	打印
匯流排	總線
區域網	局域網
半形	半角
印表機	打印机
埠	端口
太空梭	航天飛機
字元	字符
字型檔	字庫
字符集	字符集
存檔	存盤
定址	尋址
寬頻	寬帶
快閃記憶體	閃存
感測	傳感
掃瞄器	掃描儀
控制項	控件
攜帶型	便攜式
數據機	調製解調器
晶片	芯片
模擬	仿真
欄位	字段
游標	光標
滑鼠	鼠標
演算法	算法
硬碟	硬盤
硬體	硬件
碟片	盤片
磁碟	磁盤
磁軌	磁道
簡訊	短信
網路	網路
網際網路	互聯網
行動電話	移動電話
解析度	分辨率
許可權	權限
變數	變量
資料	數據
資料庫	數據庫
資訊	信息
資訊理論	信息論
軟碟機	軟驅
軟體	軟件
載入	加載
進位制	進制
運算元	算子
防寫	寫保護
離線	脫機
非同步	異步
音效卡	聲卡
預設	缺省
預設值	默認值
顯示卡	顯卡
點陣圖	位圖